SO textures/south.png
EA textures/east.png
WE textures/west.png
NO textures/north.png

F 220,100,0

C 255,255,255

1111111111111111111111111111111111111
1N00000000000000000000000000000000001
1000000000000000000000000000000000001
1000000000000000000000000000000000001
1000000000000000000000000000000000001
1000000000000000000000000000000000001
1000000000000000000000000000000000001
1000000000000000000000000000000000001
1000000000000000000000000000000000001
1000000000000000000000000000000000001
1000000000000000000000000000000000001
1111111111111111111111111111111111111