SO textures/textures/east.xpm
EA textures/textures/east.xpm
WE textures/textures/west.xpm
NO textures/textures/north.xpm

F 255,255,255
C 0,0,0



111111111111111111
10000011111100001
1000000DDDDN0011
10000001111111111
1111111111111
