SO textures/south.png
EA textures/east.png
WE textures/west.png
NO textures/north.png


C 5,255,255
F 31,113,115

111111111111
10W001D10001
100000000001
10001D100001
100000001D11
111111111111