SO textures/south.png
EA textures/east.png
WE textures/west.png
NO textures/north.png

F 31,113,115

C 5,255,255

11 111111
10100D001
1010DWD01
10100D001
101000001
111111111