SO textures/south.png
EA textures/east.png
WE textures/west.png
NO textures/north.png

F 31,113,115

C 5,255,255

111111111
101000001
10100W001
101000001
101000001
111111111