SO textures/textures/east.xpm
EA textures/textures/east.xpm
WE textures/textures/west.xpm
NO textures/textures/north.xpm


C 5,255,255
F 31,113,115

111111111111
100000000101
10001100S01
100010100001
100000001011
111111111111

