SO textures/south.png
EA textures/east.png
WE textures/west.png
NO textures/north.png

F 255,5,4

11 1111111111111111
       1101010001111111
      111110101W0011
C 225,255,222
     110101000111111111111111
1      110100000111111111
1111111111111111
1