SO textures/textures/east.xpm
EA textures/textures/east.xpm
WE textures/textures/west.xpm
NO textures/textures/north.xpm

F 255,255,255
C 0,0,0


111111111111111111
100000000000000001
10000000000N000001
100000000000011111
1111111111111