SO textures/south.png
EA textures/east.png
WE textures/west.png
NO textures/north.png

F 31,113,115

C 5,255,255

11 111111
101010001
10101W001
101010001
101000001
111111111