SO textures/south.png
EA textures/east.png
WE textures/west.png
NO textures/north.png

F 0,0,0

C 0,0,0

111111111111111111111111111111111111
1000000000010000000000000000000000001
1000101000000000000000000000000000001
1010000000010000100000010000000000001
1000010000010000100000010000000000W1
1000000000010000100000010000000000001
1000000000010000100000010000000000001
1000000000010000100000010000000000001
1000000000010000100000010000000000001
1000000000010000000000010000000000001
1000000000010000000000010000000000001
1111100000000000001000000000000000111
1000000000000001000000000000000000011
1000000000000000100000000000000000001
1000000000010000100000010000000000001
1000000000010000100000010000000000001
1000000000010000100000010000000000001
1000000000010000100000010000000000001
1000000000010000100000010000000000001
1000000000010000100000010000000000001
1000000000010000000000010000000000001
1000000000010000000000010000000000001
1111100000000000001000000000000000111
1000000000000001000000000000000000011
1000000000000000100000000000000000001
1000000000010000100000010000000000001
1000000000010000100000010000000000001
1000000000010000100000010000000000001
1000000000010000100000010000000000001
1000000000010000100000010000000000001
1000000000010000100000010000000000001
1000000000010000000000010000000000001
1000000000010000000000010000000000001
1111100000000000001000000000000000111
1000000000000001000000000000000000011
1000000000000000100000000000000000001
1000000000010000100000010000000000001
1000000000010000100000010000000000001
1000000000010000100000010000000000001
1000000000010000100000010000000000001
1000000000010000100000010000000000001
1000000000010000100000010000000000001
1000000000010000000000010000000000001
1000000000010000000000010000000000001
1111100000000000001000000000000000111
1000000000000001000000000000000000011
1000000000000000100000000000000000001
1000000000010000100000010000000000001
1000000000010000100000010000000000001
1000000000010000100000010000000000001
1000000000010000100000010000000000001
1000000000010000100000010000000000001
1000000000010000100000010000000000001
1000000000010000000000010000000000001
1000000000010000000000010000000000001
1111100000000000001000000000000000111
1000000000000001000000000000000000011
1000000000000000100000000000000000001
1000000000010000100000010000000000001
1000000000010000100000010000000000001
1000000000010000100000010000000000001
1000000000010000100000010000000000001
1000000000010000100000010000000000001
1000000000010000100000010000000000001
1000000000010000000000010000000000001
1000000000010000000000010000000000001
1111100000000000001000000000000000111
1000000000000001000000000000000000011
1000000000000000100000000000000000001
1000000000010000100000010000000000001
1000000000010000100000010000000000001
1000000000010000100000010000000000001
1000000000010000100000010000000000001
1000000000010000100000010000000000001
1000000000010000100000010000000000001
1000000000010000000000010000000000001
1000000000010000000000010000000000001
1111100000000000001000000000000000111
1000000000000001000000000000000000011
1000000000000000100000000000000000001
1000000000010000100000010000000000001
1000000000010000100000010000000000001
1000000000010000100000010000000000001
1000000000010000100000010000000000001
1000000000010000100000010000000000001
1000000000010000100000010000000000001
1000000000010000000000010000000000001
1000000000010000000000010000000000001
1111100000000000001000000000000000111
1000000000000001000000000000000000011
1000000000000000100000000000000000001
1000000000010000100000010000000000001
1000000000010000100000010000000000001
1000000000010000100000010000000000001
1000000000010000100000010000000000001
1000000000010000100000010000000000001
1000000000010000100000010000000000001
1000000000010000000000010000000000001
1000000000010000000000010000000000001
1111100000000000001000000000000000111
1000000000000001000000000000000000011
1000000000000000100000000000000000001
1000000000010000100000010000000000001
1000000000010000100000010000000000001
1000000000010000100000010000000000001
1000000000010000100000010000000000001
1000000000010000100000010000000000001
1000000000010000100000010000000000001
1000000000010000000000010000000000001
1000000000010000000000010000000000001
1111100000000000001000000000000000111
1000000000000001000000000000000000011
1000000000000000100000000000000000001
1000000000010000100000010000000000001
1000000000010000100000010000000000001
1000000000010000100000010000000000001
1000000000010000100000010000000000001
1000000000010000100000010000000000001
1000000000010000100000010000000000001
1000000000010000000000010000000000001
1000000000010000000000010000000000001
1111100000000000001000000000000000111
1000000000000001000000000000000000011
1000000000000000100000000000000000001
1000000000010000100000010000000000001
1000000000010000100000010000000000001
1000000000010000100000010000000000001
1000000000010000100000010000000000001
1000000000010000100000010000000000001
1000000000010000100000010000000000001
1000000000010000000000010000000000001
1000000000010000000000010000000000001
1111100000000000001000000000000000111
1000000000000001000000000000000000011
1000000000000000100000000000000000001
1000000000010000100000010000000000001
1000000000010000100000010000000000001
1000000000010000100000010000000000001
1000000000010000100000010000000000001
1000000000010000100000010000000000001
1000000000010000100000010000000000001
1000000000010000000000010000000000001
1000000000010000000000010000000000001
1111100000000000001000000000000000111
1000000000000001000000000000000000011
1000000000000000100000000000000000001
1000000000010000100000010000000000001
1000000000010000100000010000000000001
1000000000010000100000010000000000001
1000000000010000100000010000000000001
1000000000010000100000010000000000001
1000000000010000100000010000000000001
1000000000010000000000010000000000001
1000000000010000000000010000000000001
1111100000000000001000000000000000111
1000000000000001000000000000000000011
1000000000000000100000000000000000001
1000000000010000100000010000000000001
1000000000010000100000010000000000001
1000000000010000100000010000000000001
1000000000010000100000010000000000001
1000000000010000100000010000000000001
1000000000010000100000010000000000001
1000000000010000000000010000000000001
1000000000010000000000010000000000001
1111100000000000001000000000000000111
1000000000000001000000000000000000011
1000000000000000100000000000000000001
1000000000010000100000010000000000001
1000000000010000100000010000000000001
1000000000010000100000010000000000001
1000000000010000100000010000000000001
1000000000010000100000010000000000001
1000000000010000100000010000000000001
1000000000010000000000010000000000001
1000000000010000000000010000000000001
1111100000000000001000000000000000111
1000000000000001000000000000000000011
1000000000000000100000000000000000001
1000000000010000100000010000000000001
1000000000010000100000010000000000001
1000000000010000100000010000000000001
1000000000010000100000010000000000001
1000000000010000100000010000000000001
1000000000010000100000010000000000001
1000000000010000000000010000000000001
1000000000010000000000010000000000001
1111100000000000001000000000000000111
1000000000000001000000000000000000011
1000000000000000100000000000000000001
1000000000010000100000010000000000001
1000000000010000100000010000000000001
1000000000010000100000010000000000001
1000000000010000100000010000000000001
1000000000010000100000010000000000001
1000000000010000100000010000000000001
1000000000010000000000010000000000001
1000000000010000000000010000000000001
1111100000000000001000000000000000111
1000000000000001000000000000000000011
1000000000000000100000000000000000001
1000000000010000100000010000000000001
1000000000010000100000010000000000001
1000000000010000100000010000000000001
1000000000010000100000010000000000001
1000000000010000100000010000000000001
1000000000010000100000010000000000001
1000000000010000000000010000000000001
1000000000010000000000010000000000001
1111100000000000001000000000000000111
1000000000000001000000000000000000011
1000000000000000100000000000000000001
1000000000010000100000010000000000001
1000000000010000100000010000000000001
1000000000010000100000010000000000001
1000000000010000100000010000000000001
1000000000010000100000010000000000001
1000000000010000100000010000000000001
1000000000010000000000010000000000001
1000000000010000000000010000000000001
1111100000000000001000000000000000111
1000000000000001000000000000000000011
1000000000000000100000000000000000001
1000000000010000100000010000000000001
1000000000010000100000010000000000001
1000000000010000100000010000000000001
1000000000010000100000010000000000001
1000000000010000100000010000000000001
1000000000010000100000010000000000001
1000000000010000000000010000000000001
1000000000010000000000010000000000001
1111100000000000001000000000000000111
1000000000000001000000000000000000011
1000000000000000100000000000000000001
1000000000010000100000010000000000001
1000000000010000100000010000000000001
1000000000010000100000010000000000001
1000000000010000100000010000000000001
1000000000010000100000010000000000001
1000000000010000100000010000000000001
1000000000010000000000010000000000001
1000000000010000000000010000000000001
1111100000000000001000000000000000111
1000000000000001000000000000000000011
1000000000000000100000000000000000001
1000000000010000100000010000000000001
1000000000010000100000010000000000001
1000000000010000100000010000000000001
1000000000010000100000010000000000001
1000000000010000100000010000000000001
1000000000010000100000010000000000001
1000000000010000000000010000000000001
1000000000010000000000010000000000001
1111100000000000001000000000000000111
1000000000000001000000000000000000011
1000000000000000100000000000000000001
1000000000010000100000010000000000001
1000000000010000100000010000000000001
1000000000010000100000010000000000001
1000000000010000100000010000000000001
1000000000010000100000010000000000001
1000000000010000100000010000000000001
1000000000010000000000010000000000001
1000000000010000000000010000000000001
1111100000000000001000000000000000111
1000000000000001000000000000000000011
1000000000000000100000000000000000001
1000000000010000100000010000000000001
1000000000010000100000010000000000001
1000000000010000100000010000000000001
1000000000010000100000010000000000001
1000000000010000100000010000000000001
1000000000010000100000010000000000001
1000000000010000000000010000000000001
1000000000010000000000010000000000001
1111100000000000001000000000000000111
1000000000000001000000000000000000011
1000000000000000100000000000000000001
1000000000010000100000010000000000001
1000000000010000100000010000000000001
1000000000010000100000010000000000001
1000000000010000100000010000000000001
1000000000010000100000010000000000001
1000000000010000100000010000000000001
1000000000010000000000010000000000001
1000000000010000000000010000000000001
1111100000000000001000000000000000111
1000000000000001000000000000000000011
1000000000000000100000000000000000001
1000000000010000100000010000000000001
1000000000010000100000010000000000001
1000000000010000100000010000000000001
1000000000010000100000010000000000001
1000000000010000100000010000000000001
1000000000010000100000010000000000001
1000000000010000000000010000000000001
1000000000010000000000010000000000001
1111100000000000001000000000000000111
1000000000000001000000000000000000011
1000000000000000100000000000000000001
1000000000010000100000010000000000001
1000000000010000100000010000000000001
1000000000010000100000010000000000001
1000000000010000100000010000000000001
1000000000010000100000010000000000001
1000000000010000100000010000000000001
1000000000010000000000010000000000001
1000000000010000000000010000000000001
1111100000000000001000000000000000111
1000000000000001000000000000000000011
1000000000000000100000000000000000001
1000000000010000100000010000000000001
1000000000010000100000010000000000001
1000000000010000100000010000000000001
1000000000010000100000010000000000001
1000000000010000100000010000000000001
1000000000010000100000010000000000001
1000000000010000000000010000000000001
1000000000010000000000010000000000001
1111100000000000001000000000000000111
1000000000000001000000000000000000011
1000000000000000100000000000000000001
1000000000010000100000010000000000001
1000000000010000100000010000000000001
1000000000010000100000010000000000001
1000000000010000100000010000000000001
1000000000010000100000010000000000001
1000000000010000100000010000000000001
1000000000010000000000010000000000001
1000000000010000000000010000000000001
1111100000000000001000000000000000111
1000000000000001000000000000000000011
1000000000000000100000000000000000001
1000000000010000100000010000000000001
1000000000010000100000010000000000001
1000000000010000100000010000000000001
1000000000010000100000010000000000001
1000000000010000100000010000000000001
1000000000010000100000010000000000001
1000000000010000000000010000000000001
1000000000010000000000010000000000001
1111100000000000001000000000000000111
1000000000000001000000000000000000011
1000000000000000100000000000000000001
1000000000010000100000010000000000001
1000000000010000100000010000000000001
1000000000010000100000010000000000001
1000000000010000100000010000000000001
1000000000010000100000010000000000001
1000000000010000100000010000000000001
1000000000010000000000010000000000001
1000000000010000000000010000000000001
1111100000000000001000000000000000111
1000000000000001000000000000000000011
1000000000000000100000000000000000001
1000000000010000100000010000000000001
1000000000010000100000010000000000001
1000000000010000100000010000000000001
1000000000010000100000010000000000001
1000000000010000100000010000000000001
1000000000010000100000010000000000001
1000000000010000000000010000000000001
1000000000010000000000010000000000001
1111110000000000000100000000000011111
1000000000000000100000000000000000001
1000000000010000100000010000000000001
1000000000010000100000010000000000001
1000000000010000100000010000000000001
1000000000010000100000010000000000001
1000000000010000100000010000000000001
1000000000010000100000010000000000001
1000000000010000000000010000000000001
1000000000010000000000010000000000001
1111111111111111111111111111111111111