SO textures/south.xpm
EA textures/south.xpm
WE textures/south.xpm
NO textures/north.xpm

F 0,0,0
C 255,255,255

111111111111111111
100000N000000011
1000000000000001
1000000000000001
111111111111111111
