SO textures/south.png
EA textures/east.png
WE textures/west.png
NO textures/north.png

F 220,100,0

C 255,255,255

1111111111111111111111111111111111111
1N00000000000000100000000000000000001
1000000000000000100000000000000000001
1000000000010000100000010000000000001
1000000000010000100000010000000000001
1000000000010000100000010000000000001
1000000000010000100000010000000000001
1000000000010000100000010000000000001
1000000000010000100000010000000000001
1000000000010000000000010000000000001
1000000000010000000000010000000000001
1111100000000000001000000000000000111
1000000000000001000000000000000000011
1000000000000000100000000000000000001
1000000000010000100000010000000000001
1000000000010000100000010000000000001
1000000000010000100000010000000000001
1000000000010000100000010000000000001
1000000000010000100000010000000000001
1000000000010000100000010000000000001
1000000000010000000000010000000000001
1000000000010000000000010000000000001
1111110000000000000100000000000011111
1000000000000000100000000000000000001
1000000000010000100000010000000000001
1000000000010000100000010000000000001
1000000000010000100000010000000000001
1000000000010000100000010000000000001
1000000000010000100000010000000000001
1000000000010000100000010000000000001
1000000000010000000000010000000000001
1000000000010000000000010000000000001
1111111111111111111111111111111111111