SO textures/east.xpm
EA textures/east.xpm
WE textures/west.xpm
NO textures/north.xpm


F 0,10,110
C 55,5,25

1111111111111111111111111111111111111111111111111111111111111111111111111111111111111111111111111111111111111111111111111111111111111
10000000001100000000000000000000000000000N000000000000000000000000000000000000000000000000001000000000100001
10000000001100000000000000000000000000000000000000000000000000000000000000000000000000000001000000000100001
100000000011000000000000000000000000000000000000000000000000000000000000000000000000000000001000000000100001
100000000011000000000000000000000000000000000000000000000000000000000000000000000000000000001000000000100001
100000000011000000000000000000000000000000000000000000000000000000000000000000000000000000001000000000100001
100000000011000000000000000000000000000000000000000000000000000000000000000000000000000000001000000000100001
100000000011000000000000000000000000000000000000000000000000000000000000000000000000000000001000000000100001
1111111111111111111111111111111111111111111111111111111111111111111111111111111111111111111111111111111111111111111111111111