SO textures/south.xpm
EA textures/east.xpm
WE textures/west.xpm
NO textures/north.xpm

F 31,113,2
C 255,255,255


111111111111
10E000000001
100000001111
111111111