SO textures/south.png
EA textures/east.png
WE textures/west.png
NO textures/north.png

C 5,255,1


111111111
F 31,113,2
10E001111
111111111