SO textures/east.xpm
EA textures/east.xpm
WE textures/west.xpm
NO textures/north.xpm

F 31,113,2
C 5,255,1


111111111111111111
100000000000000001
10000000000N000101
100000000100011111
1111111111111